111111111111111111111111111111111111111111111111111111111111
1E0000000000000C00000C00000000000000000000000000000000000001
101001010010000010100100000001010000000000000000000000000001
101001010010000010100100000001010000000000000000000000000001
101001010010000010100100000001010000000000000000000000000001
101001010010000010100100000001010000000000000000000000000001
101001010010000010100100000001010000000000000000000000000001
101001010010000010100100000001010000000000000000000000000001
101001010010000010100100000001010000000000000000000000000001
101001010010000010100100000001010000000000000000000000000001
101001010010000010100100000001010000000000000000000000000001
101001010010000010100100000001010000000000000000000000000001
101001010010000010100100000001010000000000000000000000000001
101001010010000010100100000001010000000000000000000000000001
101001010010000010100100000001010000000000000000000000000001
101001010010000010100100000001010000000000000000000000000001
101001010010000010100100000001010000000000000000000000000001
101001010010000010100100000001010000000000000000000000000001
101001010010000010100100000001010000000000000000000000000001
101001010010000010100100000001010000000000000000000000000001
101001010010000010100100000001010000000000000000000000000001
101001010010000010100100000001010000000000000000000000000001
101001010010000010100100000001010000000000000000000000000001
101001010010000010100100000001010000000000000000000000000001
101001010010000010100100000001010000000000000000000000000001
101001010010000010100100000001010000000000000000000000000001
101001010010000010100100000001010000000000000000000000000001
101001010010000010100100000001010000000000000000000000000001
101001010010000010100100000001010000000000000000000000000001
101001010010000010100100000001010000000000000000000000000001
10000000C00C0000000000000000000C00000000000000000000000000P1
111111111111111111111111111111111111111111111111111111111111